=============================================================================================================================================
|┤┤┤┤┤┤┤┤┤┤┤┤┤┤┤┤┤┤┤┤┤┤┤┤┤┤┤┤┤┤┴|┤┤┤┤┤┤┤┤┤┤┤┤┤┤┤┤┤┤┤┤┤┤┤┤┤┤┤┤┤┤┤┤┤┤┴├├├├├├├├├├├├├├├├├├├├├├├├├├├├├├├├├├├├├├├├├├├├├├├├├├├├├├├├├├├├├├├├├├├├├*├├|
|┤┤┤*┤┤┤┤┤┤┤┤┤┤┤┤┤┤┤┤┤┤┤┤┤┤┤┤┤┤┴|┤┤┤┤┤┤┤┤┤┤┤┤┤┤┤┤┤┤┤┤┤┤┤┤┤┤┤┤┤┤┤┤┤┤┴├├├├├├├├├├├├├├├├├├├├├├├├├├├├├├├├├├├├├├├├├├├├├├├├├├├├├├├├├├├├├├├├├├├├├├├├|
|┤┤┤┤┤┤┤┤┤┤┤┤┤┤┤┤┤┤┤┤┤┤┤┤┤┤┤┤┤┤┴|┤┤┤┤┤┤┤┤┤┤┤┤┤┤┤┤┤┤┤*┤┤┤┤┤┤┤┤┤┤┤┤┤┤┴├├├├├├├├├├├├├├├├├├├├├├├├├├├├├├├├├├├├├├├├├├├├├├├├├├├├├├├├├├├├├├├├├├├├├├├├|
|┤┤┤┤┤┤┤┤┤┤┤┤┤┤┤┤┤┤┤┤┤┤┤┤┤┤┤┤┤┤┤┤┤┤┤┤┤┤┤┤┤┤┤┤┤┤┤┤┤┤┤┤┤┤┤┤┤┤┤┤┤┤┤┤┤┤┴├├├├├├├├├├├├├├├├├├├├├├├├├├├├├├├├├├├├├├├├├├├├├├├├├├├├├├├├├├├├├├├├├├├├├├├├|
|┤┤┤┤┤┤┤┤┤┤┤┤┤┤┤┤┤┤┤┤┤┤┤┤┤┤┤┤┤┤┤┤┤┤┤┤┤┤┤┤┤┤┤┤┤┤┤┤┤┤┤┤┤┤┤┤┤┤┤┤┤┤┤┤┤┤┴├├├├├├├├├=================┬┬┬┬┬┬┬┬┬┬┬==================================┬|
|┤┤┤┤┤┤┤┤┤┤┤┤┤┤┤┤┤┤┤┤┤┤┤┤┤┬|┤┤┤┬|┤┤┤┤┤┤┤┤┤┤┤┤┤┤┤┤┤┤┤┤┤┤┤┤┤┤┤┤┤┤┤┤┤┤┴├├├├├├├├├|┤┤┤┤┤┤┤┤┤┤┤┤┤┤┤┤┬┬┬┬┬┬┬┬┬┬┬├├├├├├|┴├├├├├├├├├├├├├├├├┤┤┤┤┤┤┤┤┤┤┬|
|┤┤┤┤┤┤┤┤┤┤┤┤┤┤┤┤┤┤┤┤┤┤┤┤┤┬|┤*┤┬|┤┤┤┤┤┤┤┤┤┤┤┤┤┤┤┤┤┤┤┤┤┤┤┤┤┤┤┤┤┤┤┤┤┤┴├├├├├├├├├|┤┤┤┤┤┤┤┤┤┤┤┤┤┤┤┤┬┬┬┬┬┬┬┬┬┬┬┬┬┬┬┬┬|┴├*├├├├├├├├├├├├├├├┤┤┤┤┤┤┤┤┤┬|
|┤┤┤┤┤┤┤┤┤┤┤┤┤┤┤┤┤┤┤┤┤┤┤┤┤┬|┤┤┤┬|┤┤┤┤┤┤┤┤┤┤┤┤┤┤┤┤┤┤┤┤┤┤┤┤┤┤┤┤┤┤┤┤┤┤┴├├├├├├├├├|┤┤┤┤┤┤┤┤┤┤┤┤┤┤┤┤┬┬┬┬┬┬┬┬┬┬┬┬┬┬┬┬┬|┴├├├├├├├├├├├├├├├├├├┤┤┤┤┤┤┤┤┬|
|┤┤┤┤┤┤┤┤┤┤┤┤┤┤┤┤┤┬======================┤┤┤┤┤┤┤┤┤┤┤┤┤┤┤┤┤┤┤┤┤┤┤┤┤┤┴├├├├├├├├├|┤┤┤┤┤┤┤┤┬|┤┤┤┤┤┤┬┬┬┬┬┬┬┬┬┬┬┬┬┬┬┬┬|┴├├├├├├├├├├├├├├├├├├├┤┤┤┤┤┤┤┬|
|┤┤┤┤┤┤┤┤┤┤┤┤┤┤┤┤┤┬├├├├├├├├|    |┤┤┤┤┤┤┤┤┤┤┤┤┤┤┤┤┤┤┤┤┤┤┤┤┤┤┤┤┤┤┤┤┤┤s├├├├├├├├├|┤┤┤┤┤┤┤┤┬|┤┤┤┤┤┤┬┬┬┬┬┬┬┬┬┬┬┬┬┬┬┬┬|┴├├├├├├├├├├├├├├├├├├├├┤┤┤┤┤┤┬|
|┤┤┤┤┤┤┤┤┤┤┤┤┤┤┤┤┤┬┬┬*┬┬┬┬┬|  * |┤┤┤*┤┤┤┤┤┤┤┤┤┤┤┤┤┤┤┤┤┤┤┤┤┤┤┤┤┤┤┤┤┤┬┬┬┬┬┬┬┬┬┬|┤┤┤┤┤┤┤┤┬|┤┤┤┤┤┤┬┬┬┬┬┬┬┬┬┬┬┬┬┬┬┬┬|┴├├├├├├├├├├├├├├├├├├├├├┤┤┤┤┤┬|
|┤┤┤┤┤┤┤┤┤┤┤┤┤┤┤┤┤┬┬┬┬┬┬┬┬┬|    |┤┤┤┤┤┤┤┤┤┤┤┤┤┤┤┤┤┤┤┤┤┤┤┤┤┤┤┤┤┤┤┤┤┤┬┬┬┬┬┬┬┬┬┬|┤┤┤┤┤┤┤┤┬|┤┤┤┤┤┤┬┬┬┬┬┬┬*┬┬┬┬┬┬┬┬┬|┴├├├├├├├├├├├├├├├├├├├├├├┤┤┤┤┬|
|┤┤┤┤┤┤┤┤┤┤┤┤┤┤┤┤┤┴======================┤┤┤┤┤┤┤┤┤┤┤┤┤┤┤*┤┤┤┤┤┤┤┤┤┤┬┬┬┬┬┬┬┬┬┬|┤┤┤┤┤┤┤┤┬|┤┤┤┤┤┤┬┬┬┬┬┬┬┬┬┬┬┬┬┬┬┬┬|┴├├├├├├├├├├├├├├├├├├├├├├├┤┤┤┬|
|┤┤┤┤┤┤┤┤┤┤┤┤┤┤┤┤┤┤┤┤┤┤┤┤┤┴|┤┤┤┴|┤┤┤┤┤┤┤┤┤┤┤┤┤┤┤┤┤┤┤┤┤┤┤┤┤┤┤┤┤┤┤┤┤┤┬┬┬┬┬┬┬┬┬┬|┤┤┤┤┤┤┤┤┬|┤┤┤┤┤┤┬┬┬┬┬┬┬┬┬┬┬┬┬┬┬┬┬|┴├├├├├├├├├├├├├├├├├├├├├├├├┤┤┬|
|┤┤┤┤┤┤┤┤┤┤┤┤┤┤┤┤┤┤┤┤┤┤┤┤┤┴|┤┤*┴|┤┤┤┤┤┤┤┤┤┤┤┤┤┤┤┤┤┤┤┤┤┤┤┤┤┤┤┤┤┤┤┤┤┤┬┬┬┬┬┬┬┬┬┬|┤┤┤┤┤┤┤┤┬|┤┤┤┤┤┤┬┬┬┬┬┬┬┬┬┬┬┬┬┬┬┬┬|┴├├├├├├├├├├├├├├├├├├├├├├├├├┤┬|
|┤┤┤┤┤┤┤┤┤┤┤┤┤┤┤┤┤┤┤┤┤┤┤┤┤┴|┤┤┤┴|┤┤┤┤┤┤┤┤┤┤┤┤┤┤┤┤┤┤┤┤┤┤┤┤┤┤┤┤┤┤┤┤┤┤┬┬┬┬┬┬┬┬┬┬|┤┤┤┤┤┤┤┤┬|┤┤┤┤┤┤┬┬┬┬┬┬┬┬┬┬┬┬┬┬┬┬┬├├├├├├├├├├├├├├├├├├├├├├├├├├├├┬|
|======┤┤┤┤┤┤┤┤┤┤┤┤┤┤┤┤┤┤┤┤┤┤┤┤┤┤┤┤┤┤┤┤┤┤┤┤┤┤┤┤┤┤┤┤┤┤┤┤┤┤┤┤┤┤┤┤┤┤┤┤┬┬┬┬┬┬┬┬┬┬|┤┤┤┤┤┤┤┤┬|┤┤┤┤┤┤┬┬┬┬┬┬┬┬┬┬┬┬┬┬┬┬┬┬┬┬┬┬┬┬┬┬┬┬┬┬┬┬┬┬┬┬┬┬┬┬┬┬┬┬┬┬|
|     |┤┤┤┤┤┤┤┤┤┤┤┤┤┤┤┤┤┤┤┤┤┤┤┤┤┤┤┤┤┤┤┤┤┤┤┤┤┤┤┤┤┤┤┤┤┤┤┤┤┤┤┤┤┤┤┤┤┤┤┤┬┬┬┬┬┬┬┬┬┬|┤┤┤┤*┤┤┤┬|┤┤┤┤┤┤┬┬┬┬┬┬┬┬┬┬┬┬┬┬┬┬┬┬┬┬┬┬┬┬┬┬┬┬┬┬┬┬┬┬┬┬┬┬┬┬┬┬*┬┬┬|
|  *  |┤┤┤┤┤┤┤┤┤┤┤┤┤┤┤┤┤┤┤┤┤┤┤┤┤┤┤┤┤┤┤┤┤┤┤┤┤┤┤┤┤┤┤┤┤┤┤┤┤┤┤┤┤┤┤┤┤┤┤┤┬┬┬┬┬┬┬┬┬┬|┤┤┤┤┤┤┤┤┬|┤┤┤┤┤┤┬┬┬┬┬┬┬┬┬┬┬┬┬┬┬┬┬┬┬┬┬┬┬┬┬┬┬┬┬┬┬┬┬┬┬┬┬┬┬┬┬┬┬┬┬┬|
=============================================================================================================================================
