==========================================================================
|┤┤s├├├├├├├├├├├├├├├├├├├├├├├├├├├├├├|┴├├├├├├├├├├├├├├├├├├├├├├├├├├├├├├├├├├├├├|
|┤┤┬┬┬┬┬┬┬┬┬┬┬┬┬┬┬┬┬┬┬┬┬┬┬┬┬┬┬┬┬┬┬|┴├├├├├├├├├├├├├├├├├├├├├├├├├├├├├├├├├├├├├|
|====================┬┬┬┬┬┬┬┬┬┬┬┬┬|┴├├├├├├├├├├├├├├├├├├├├├├├├├├├├├├├├├├├├├|
|┤┤┤┤┤┤┤┤┤┤┤┤┤┤┤┤┤┤┤┤┬┬┬┬┬┬┬┬┬┬┬┬┬├├├├├├├├├├├├├├├├├├├├├├├├├├├├├├├├├├├├├├├|
|┤┤┤┤┤┤┤┤┤┤┤┤┤┤┤┤┤┤┤┤┬┬┬┬┬┬┬┬┬┬┬┬┬┬┬┬┬┬┬┬┬┬┬┬┬┬┬┬┬┬┬┬┬┬┬┬┬┬┬┬┬*┬┬┬┬┬┬┬┬┬┬|
|┤┤┤┤┤┤┤┤┤┤┤┤┤┤┤┤┤┬===================┬┬┬┬┬┬┬┬┬┬┬┬┬┬┬┬┬┬┬┬┬┬┬┬┬┬┬┬┬┬┬┬┬┬┬|
|┤┤┤┤┤┤┤┤┤┤┤┤┤┤┤┤┤┬├├├├├├├├├├├├├├├├┤┤┤┬┬┬┬┬┬┬┬┬┬┬┬┬┬┬┬┬┬┬┬┬┬┬┬┬┬┬┬┬┬┬┬┬┬┬|
|┤┤┤┤┤┤┤┤┤┤┤┤┤┤┤┤┤┬┬┬┬┬┬┬┬┬┬┬┬┬┬┬┬┬┤┤┤┬┬┬┬┬┬┬┬┬┬┬┬┬┬┬┬┬┬┬┬┬┬┬┬┬┬┬┬┬┬┬┬┬┬┬|
|┤┤┤┤┤┤┤┤┤┤┤┤┤┤┤┤┤┬┬┬┬┬┬┬┬┬┬┬┬┬┬┬┬┬┤┤┤┬┬┬┬┬┬┬┬┬┬┬┬┬┬┬┬┬┬┬┬┬┬┬┬┬┬┬┬┬┬┬┬┬┬┬|
|┤┤┤┤┤┤┤┤┤┤┤┤┤┤┤┤*┬┬┬┬┬┬┬┬┬┬┬┬┬┬┬┬┬┤┤┬==========================┬┬┬┬┬┬┬┬┬|
|┤┤┤┤┤┤┤┤┤┤┤┤┤┤┤┤┤┬┬┬┬┬┬┬┬┬┬┬┬┬┬┬┬┬┤┤┬├├├├├├├├├├├├├├├├├├├├├├├├├┤┬┬┬┬┬┬┬┬┬|
|┤┤┤┤┤┤┤┤┤┤┤┤┤┤┤┤┤┬┬┬┬┬┬┬┬┬┬┬┬┬┬┬┬┬┤┤┬┬┬┬┬┬┬┬┬┬┬┬┬┬┬┬┬┬┬┬┬┬┬┬┬┬┤┬┬┬┬┬┬┬┬┬|
|┤┤┤┤┤┤┤┤┤┤┤┤┤┤┤┤┤┬┬┬┬┬┬┬┬┬┬┬┬┬┬┬┬┬┤┤┬┬┬┬┬┬┬┬┬┬┬|┬┬┬┬┬┬┬┬┬┬┬┬┬┬┤┬┬┬┬┬┬┬┬┬|
|================================┬┬┤┤┬┬┬┬┬┬┬┬┬┬┬|┬┬┬┬┬┬┬┬┬┬┬┬┬┬┤┬┬┬┬┬┬┬┬┬|
|┤┤┤┤┤┤┤┤┤┤┤┤┤┤┤┤┤┤┤┤┤┤┤┤┤┤┤┤┤┤┤┤┬┬┤┤┬┬┬┬┬┬┬┬┬┬┬|┬┬┬┬┬┬┬┬┬┬┬┬┬┬┤┬┬┬┬┬┬┬┬┬|
|┤┤┤┤┤┤┤┤┤┤┤┤┤┤┤┤┤┤┤┤┤*┤┤┤┤┤┤┤┤┤┤┬┬┤┤┬┬┬┬┬┬┬┬┬┬┬|┬┬┬┬┬┬┬┬┬┬┬┬┬┬┤┬┬┬┬┬┬┬┬┬|
|┤┤┤┤┤┤┤┤┤┤┤┤┤┤┤┤┤┤┤┤┤┤┤┤┤┤┤┤┤┤┤┤┬┬┤┤┬┬┬┬┬┬┬┬┬┬┬|┬┬┬┬┬┬┬┬┬┬┬┬┬┬┤┬┬┬┬┬┬┬┬┬|
|┤┤┤┤┤┤┤┤┤┤┤┤┤┤┤┤┤┤┤┤┤┤┤┤┤┤┤┤┤┤┤┤┬┬┤┤┬┬┬┬┬┬┬┬┬┬┬|┬┬┬┬┬┬┬┬┬┬┬┬┬┬┤┬┬┬┬┬┬┬┬┬|
|┤┤┤┤┤┤┤┤┤┤┤┤┤┤┤┤┤┤┤┤┤┤┤┤┤┤┤┤┤┤┤┤┬┬┤┤┬┬┬┬┬┬┬┬┬┬┬|┬┬┬┬┬┬┬┬┬┬┬┬┬┬┤┬┬┬┬┬┬┬┬*|
=========================================================================
