==========================================================================
|┤┤┤s├├├├├├├├├├├├├├├├├├├├├├├├├├├├├├├├├├├├├├├├├├├├├├├├├├├├├├├├├├├├├├├├├├├├|
|┤┤┤┬┬┬┬┬┬┬┬┬┬┬┬┬┬┬┬┬┬┬┬┬┬┬┬┬┬┬┬┬┬┬┬┬┬┬┬┬*┬┬┬┬┬┬┬┬┬┬┬┬┬┬┬┬┬┬┬┬┬┬┬┬┬┬┬┬┬┬┬|
|=======================================================┬┬┬┬┬┬┬┬┬┬┬┬┬┬┬┬┬|
|┤┤┤┤┤┤┤┤┤┤┤┤┤┤┤┤┤┤┤┤┤┤┤┤┤┤┤┤┤┤┤┤┤┤┤┤┤┤┤┤┤┤┤┤┤┤┤┤┤┤┤┤┤┤┤┬┬┬┬┬┬┬┬┬┬┬┬┬┬┬┬┬|
|┤┤┤*┤┤┤┤┤┤┤┤┤┤┤┤┤┤┤┤┤┤┤┤┤┤┤┤┤┤┤┤┤┤┤┤┤┤┤┤┤┤┤*┤┤┤┤┤┤┤┤┤┤┤┬┬┬┬┬┬┬┬┬┬┬┬┬┬┬┬┬|
|┤┤┤┤┤┤┤┤┤┤┤┤┤┤┤┤┤┤┤┤┤┤┤┤┤┤┤┤┤┤┤┤┤┤┤┤┤┤┤┤┤┤┤┤┤┤┤┤┤┤┤┤┤┤┤┬┬┬┬┬┬┬┬┬┬┬┬┬┬┬┬┬|
|┤┤┤┤┤┤┤┤┤┤┤┤┤┤┤┤┤┤┤┤┤┤┤┤┤*┤┤┤┤┤┤┤┤┤┤┤┤┤┤┤┤┤┤┤┤┤┤┤┤┤┤┤┤┤┬┬┬┬┬┬┬┬┬┬┬┬┬┬┬┬┬|
|┤┤┤┤┤┤┤┤┤┤┬=======================================================┬┬┬┬┬┬|
|┤┤┤┤┤┤┤┤┤┤┬├├├├├├├├├├┤┤┤┤┤┤┤┤┤┤┤┤┤┤┤┤┤┤┤┤┤┤┤┤┤┤┤┤┤┤┤┤┤┤┤┤┤┤┤┤┤┤┤┤┤┬┬┬┬┬┬|
|┤┤┤┤┤┤┤┤*┤┬┬┬┬┬┬┬┬┬┬┬┤┤┤┤┤┤┤┤┤┤┤┤┤┤┤┤┤┤┤┤┤┤┤┤┤┤┤┤┤┤┤┤┤┤┤┤┤┤┤┤┤┤┤┤┤┬┬┬┬┬┬|
|┤┤┤┤┤┤┤┤┤┤┬┬┬┬┬┬┬┬┬┬┬┤┤┤┤┤┤┤┤┤┤┤┤┤┤┤┤┤┤┤┤┤┤┤┤┤┤┤┤┤┤┤┤┤┤┤┤┤┤┤┤┤┤┤┤┤┬┬┬┬┬┬|
|==========================================================┤┤┤┤┤┤┤┤┬┬┬┬┬┬|
|┤┤┤┤┤┤┤┤┤┤┤┤┤┤┤┤┤┤┤┤┤┤┤┤┤┤┤┤┤┤┤┤┤┤┤┤┤┤┤┤┤┤┤┤┤┤┤┤┤┤┤┤┤┤┤┤┤┤┤┤┤┤┤┤┤┤┬┬┬┬┬┬|
|┤┤┤┤┤┤┤┤┤┤┤┤┤┤┤┤┤┤┤┤┤*┤┤┤┤┤┤┤┤┤┤┤┤┤┤┤┤┤┤┤┤┤┤*┤┤┤┤┤┤┤┤┤┤┤┤┤┤┤┤┤┤┤┤┤┬┬┬┬┬┬|
|┤┤┤┤┤┤┤┤┤┤┤┤┤┤┤┤┤┤┤┤┤┤┤┤┤┤┤┤┤┤┤┤┤┤┤┤┤┤┤┤┤┤┤┤┤┤┤┤┤┤┤┤┤┤┤┤┤┤┤┤┤┤┤┤┤┤┬┬┬┬┬┬|
|┤┤┤┤┤┤┤┬=======================================================┤┤┤┬┬┬┬┬┬|
|┤┤┤┤┤┤┤┤┤┤┤┤┤┤┤┤┤┤┤┤┤┤┤┤┤┤┤┤┤┤┤┤┤┤┤┤┤┤┤┤┤┤┤┤┤┤┤┤┤┤┤┤┤┤┤┤┤┤┤┤┤┤┤┤┤┤┬┬┬┬┬┬|
|┤┤┤┤┤┤┤┤┤┤┤┤*┤┤┤┤┤┤┤┤┤┤┤┤┤┤┤┤┤*┤┤┤┤┤┤┤┤┤┤┤┤┤┤┤┤┤┤┤┤┤*┤┤┤┤┤┤┤┤┤┤┤┤┤┬┬┬┬┬┬|
|┤┤┤┤┤┤┤┤┤┤┤┤┤┤┤┤┤┤┤┤┤┤┤┤┤┤┤┤┤┤┤┤┤┤┤┤┤┤┤┤┤┤┤┤┤┤┤┤┤┤┤┤┤┤┤┤┤┤┤┤┤┤┤┤┤┤┬┬┬┬┬┬|
==========================================================================
