==========================================================================
|┤┴┤s├├├├├├├├├├├├├├├├├├├├├├├├├├├├├├├├├├├├├├├├├├├├├├├├├├├├├├├├├├├├├├├├├├├├|
|┤┤┤┬┬┬┬┬┬┬┬┬┬┬┬┬┬┬┬┬┬┬┬┬┬┬┬┬┬┬┬┬┬┬┬┬┬┬┬┬*┬┬┬┬┬┬┬┬┬┬┬┬┬┬┬┬┬┬┬┬┬┬┬┬┬┬┬┬┬┬┬|
|=======================================================┴├├├├├├├├├├┤┤┤┴┤┬|
|┤┤┴┤┤┤┴┤┤┤┴├├├├├├├├├├├├├├├├├├├├├├├├├├├├├├├├├├├├├├├├├├├├├├┬┬┬┬┬┬┬┬┬┤┬┤┴┤┬|
|┬┤┴*┬┤┴┤┬┤┴├┬┬┬┬┬┬┬┬┬┬┬┬┬┬┬┬┬┬┬┬┬┬┬┬┬┬┬┬┬┬┬*┬┬┬┬┬┬┬┬┬┬┬┬┤┤┤┴┤┤┤┴┤┬┤┬┤┴┤┬|
|┬┤┴┤┬┤┴┤┬┤┴├┤┤┤┴┤┤┤┴┤┤┤┴┤┤┤┴┤┤┤┴┤┤┤┴┤┤┤┴┤┤┤┴┤┤┤┴┤┤┤┴┤┤┤┴┤┬┤┴┤┬┤┴┤┬┤┬┤┴┤┬|
|┬┤┴┤┬┤┴┤┬┤┴├┤┬┤┤┤┬┤┤┤┬┤┤┤*┤┤┤┬┤┤┤┬┤┤┤┬┤┤┤┬┤┤┤┬┤┤┤┬┤┤┤┬┤┤┤┬┤┤┤┬┤┤┤┬┤┬┤┴┤┬|
|┬┤┴┤┬┤┴┤┬┤┴=======================================================┤┬┤┴┤┬|
|┬┤┴┤┬┤┴┤┬┤┴┤┤┤┴┤┤┤┴┤┤┤┴┤┤┤┴┤┤┤┴┤┤┤┴┤┤┤┴┤┤┤┴┤┤┤┴┤┤┤┴┤┤┤┴┤┤┤┴├├├┤┤┤┴┤┬┤┴┤┬|
|┬┤┴┤┬┤┴┤*┤┴┤┬┤┴┤┬┤┴┤┬┤┴┤┬┤┴┤┬┤┴┤┬┤┴┤┬┤┴┤┬┤┴┤┬┤┴┤┬┤┴┤┬┤┴┤┬┤┴├┬┬┤┬┤┴┤┬┤┴┤┬|
|┬┤┤┤┬┤┤┤┬┤┤┤┬┤┤┤┬┤┤┤┬┤┤┤┬┤┤┤┬┤┤┤┬┤┤┤┬┤┤┤┬┤┤┤┬┤┤┤┬┤┤┤┬┤┤┤┬┤┴├┤┬┤┬┤┴┤┬┤┴┤┬|
|==========================================================┴├┤┬┤┬┤┴┤┬┤┴┤┬|
|┤┤┤┴┤┤┤┴├├├├├├├├├├├├├├├├├├├├├├├├├├├├├├├├├├├├├├├├├├├├├├├├├├├├┤┬┤┬┤┴┤┬┤┴┤┬|
|┤┬┤┴┤┬┤┴├┬┬┬┬┬┬┬┬┬┬┬┬*┬┬┬┬┬┬┬┬┬┬┬┬┬┬┬┬┬┬┬┬┬┬*┬┬┬┬┬┬┬┬┬┬┬┬┬┬┴┤┬┤┬┤┴┤┬┤┴┤┬|
|┤┬┤┴┤┬┤┴├┤┤┤┤┤┤┤┤┤┤┤┤┤┤┤┤┤┤┤┤┤┤┤┤┤┤┤┤┤┤┤┤┤┤┤┤┤┤┤┤┤┤┤┤┤┤┤┤┤┤┤┤┬┤┬┤┴┤┬┤┴┤┬|
|┤┬┤┴┤┬┤┴=======================================================┬┤┴┤┬┤┴┤┬|
|┤┬┤┴┤┬┤┤┤┴┤┤┤┴┤┤┤┴┤┤┤┴┤┤┤┴┤┤┤┴┤┤┤┴┤┤┤┴┤┤┤┴┤┤┤┴┤┤┤┴┤┤┤┴┤┤┤┴┤┤┤┴┤┬┤┴┤┬┤┴┤┬|
|┤┬┤┴┤┬├┬┤┴┤┬*┴┤┬┤┴┤┬┤┴┤┬┤┴┤┬┤┴*┬┤┴┤┬┤┴┤┬┤┴┤┬┤┴┤┬┤┴┤┬*┴┤┬┤┴┤┬┤┴┤┬┤┴┤┬┤┴┤┬|
|┤┬┤┤┤┬┬├┤┤┤┬┤┤┤┬┤┤┤┬┤┤┤┬┤┤┤┬┤┤┤┬┤┤┤┬┤┤┤┬┤┤┤┬┤┤┤┬┤┤┤┬┤┤┤┬┤┤┤┬┤┤┤┬┤┤┤┬┤┤┤┬|
==========================================================================
