=============================================================================================================================================
|┤┤┴┤┤┤┴┤┤┤┴┤┤┤┴┤┤┤┴┤┤┤┴┤┤┤┴┤┤┤┴|┴┤┤┤┴┤┤┤┴┤┤┤┴┤┤┤┴┤┤┤┴┤┤┤┴┤┤┤┴┤┤┤┴┤┴├├├├├├├├├├├├├├├├├├├├├├├├├├├├├├├├├├├├├├├├├├├├├├├├├├├├├├├├├├├├├├├├├├├├├*├├|
|┬┤┴*┬┤┴┤┬┤┴┤┬┤┴┤┬┤┴┤┬┤┴┤┬┤┴┤┬┤┴|┴┤┬┤┴┤┬┤┴┤┬┤┴┤┬┤┴┤┬┤┴┤┬┤┴┤┬┤┴┤┬┤┴┤┴├┬┬┬┬┬┬┬┬┬┬┬┬┬┬┬┬┬┬┬┬┬┬┬┬┬┬┬┬┬┬┬┬┬┬┬┬┬┬┬┬┬┬┬┬┬┬┬┬┬┬┬┬┬┬┬┬┬┬┬┬┬┬┬┬┬┬┬┬┬┬┬|
|┬┤┴┤┬┤┴┤┬┤┴┤┬┤┴┤┬┤┴┤┬┤┴┤┬┤┴┤┬┤┴|┴┤┬┤┴┤┬┤┴┤┬┤┴┤┬┤┴┤┬*┴┤┬┤┴┤┬┤┴┤┬┤┴┤┴├┤┤┤┴┤┤┤┴┤┤┤┴┤┤┤┴┤┤┤┴┤┤┤┴┤┤┤┴┤┤┤┴┤┤┤┴├├├├├├├├├├├├├├├├├├├├├├├├├├├├├├├├├┤┬|
|┬┤┴┤┬┤┴┤┬┤┴┤┬┤┴┤┬┤┴┤┬┤┴┤┬┤┴┤┬┤┤┤┴┤┬┤┴┤┬┤┴┤┬┤┴┤┬┤┴┤┬┤┴┤┬┤┴┤┬┤┴┤┬┤┴┤┴├┤┬┤┴┤┬┤┤┤┬┤┤┤┬┤┤┤┬┤┤┤┬┤┤┤┬┤┴┤┬┤┴┤┬┤┴├┬┬┬┬┬┬┬┬┬┬┬┬┬┬┬┬┬┬┬┬┬┬┬┬┬┬┬┬┬┬┬┬┤┬|
|┬┤┴┤┬┤┴┤┬┤┴┤┬┤┴┤┬┤┴┤┬┤┴┤┬┤┤┤┬├┬┤┴┤┬┤┴┤┬┤┴┤┬┤┴┤┬┤┴┤┬┤┴┤┬┤┴┤┬┤┴┤┬┤┴┤┴├┤┬┤┴┤┬├┬=================┬┤┴┤┬┤┴┤┬┤┴==================================┬|
|┬┤┴┤┬┤┴┤┬┤┴┤┬┤┴┤┬┤┴┤┬┤┴┤┬├|┴┬┬├|┴┤┬┤┴┤┬┤┴┤┬┤┴┤┬┤┴┤┬┤┴┤┬┤┴┤┬┤┴┤┬┤┴┤┴├┤┬┤┤┴┬┬├|┤┤┴┤┤┤┴┤┤┤┴┤┤┤┴┤┬┤┴┤┬┤┴┤┬┤┤┴┤┤┤┴├|┤┴┤┤┤┴┤┤┤┴┤┤┤┴┤┤┤┴┤┤┤┴┤┤┤┴┤┬|
|┬┤┴┤┬┤┴┤┬┤┴┤┬┤┴┤┬┤┴┤┬┤┤┴┬┬|┤*┬┬|┴┤┬┤┴┤┬┤┴┤┬┤┴┤┬┤┴┤┬┤┴┤┬┤┴┤┬┤┴┤┬┤┴┤┴├┤┬├┤┤┴┬┬|┬┤┴┤┬┤┴┤┬┤┴┤┬┤┴┤┬┤┴┤┬┤┴┤┬├┤┴┤┬┤┴├|┤┴*┬┤┴┤┬┤┴┤┬┤┴┤┬┤┴┤┬┤┴┤┬┤┴┤┬|
|┬┤┴┤┬┤┴┤┬┤┴┤┬┤┴┤┬┤┤┤┬├┤┤┤┬|┤┤┤┬|┤┤┬┤┤┤┬┤┴┤┬┤┴┤┬┤┴┤┬┤┴┤┬┤┴┤┬┤┴┤┬┤┴┤┴├┴┬┬├┤┴┤┬|┬┤┴┤┬┤┴┤┬┤┴┤┬┤┴┤┬┤┴┤┬┤┤┴┬┬┤┴┤┬┤┴├|┤┴┤┬┤┴┤┬┤┴┤┬┤┴┤┬┤┴┤┬┤┴┤┬┤┴┤┬|
|┬┤┴┤┬┤┴┤┬┤┴┤┬┤┴┤┬├======================┴┤┬┤┴┤┬┤┴┤┬┤┴┤┬┤┴┤┬┤┴┤┬┤┴┤┴├┤┴┬┬┤┴┤┬|┬┤┴┤┬┤┴┤┬|┴┤┬┤┴┤┬┤┴┤┬├┤┴┤┬┤┴┤┬┤┴├|┤┴┤┬┤┴┤┬┤┴┤┬┤┴┤┬┤┴┤┬┤┴┤┬┤┴┤┬|
|┬┤┴┤┬┤┴┤┬┤┴┤┬┤┤┴┬┬├├├├├├├├|    |┴┤┤┤┴┤┤┤┴┤┬┤┴┤┬┤┴┤┬┤┴┤┬┤┴┤┬┤┴┤┬┤┴┤s├┤┴┤┬┤┴┤┬|┬┤┴┤┬┤┴┤┬|┴┤┬┤┴┤┬┤┤┴┬┬┤┴┤┬┤┴┤┬┤┴├|┤┴┤┬┤┴┤┬┤┴┤┬┤┴┤┬┤┴┤┬┤┴┤┬┤┴┤┬|
|┬┤┴┤┬┤┴┤┬┤┴┤┬├┤┴├┬┬┬*┬┬┬┬┬|  * |┴┤┬*┴┤┬┤┴┤┬┤┴┤┬┤┴┤┬┤┴┤┬┤┴┤┬┤┴┤┬┤┤┴┬┤┤┴┤┬┤┴┤┬|┬┤┴┤┬┤┴┤┬|┴┤┬┤┴┤┬├┤┴┤┬┤┴┤┬┤┴┤┬┤┴├|┤┴┤┬┤┴┤┬┤┴┤┬┤┴┤┬┤┴┤┬┤┴┤┬┤┴┤┬|
|┬┤┴┤┬┤┴┤┬┤┤┴┬┬┤┴┤┤┤┤┤┤┤┤┤┬|    |┤┤┬┤┤┤┬┤┴┤┬┤┴┤┬┤┴┤┬┤┴┤┬┤┴┤┬┤┴┤┬├┤┴┤┬┤┴┤┬┤┴┤┬|┬┤┴┤┬┤┴┤┬|┴┤┬┤┤┴┬┬┤┴┤┬┤*┤┬┤┴┤┬┤┴├|┤┴┤┬┤┴┤┬┤┴┤┬┤┴┤┬┤┴┤┬┤┴┤┬┤┴┤┬|
|┬┤┴┤┬┤┴┤┬├┤┴┤┬┤┴┤┬======================┴┤┬┤┴┤┬┤┴┤┬┤┴┤┬*┴┤┬┤┤┴┬┬┤┴┤┬┤┴┤┬┤┴┤┬|┬┤┴┤┬┤┴┤┬|┴┤┬├┤┴┤┬┤┴┤┬┤┴┤┬┤┴┤┬┤┴├|┤┴┤┬┤┴┤┬┤┴┤┬┤┴┤┬┤┴┤┬┤┴┤┬┤┴┤┬|
|┬┤┴┤┬┤┤┴┬┬┤┴┤┬┤┴┤┬├├├├├├├├|┴├├├|┴├├├├├├┤┴┤┬┤┴┤┬┤┴┤┬┤┴┤┬┤┴┤┬├┤┴┤┬┤┴┤┬┤┴┤┬┤┴┤┬|┬┤┴┤┬┤┴┤┬|┤┴┬┬┤┴┤┬┤┴┤┬┤┴┤┬┤┴┤┬┤┴├|┤┴┤┬┤┴┤┬┤┴┤┬┤┴┤┬┤┴┤┬┤┴┤┬┤┴┤┬|
|┬┤┴┤┬├┤┴┤┬┤┴┤┬┤┴├┬┬┬┬┬┬┬┬┬|┴├*┬|┴├┬┬┬┬┬┤┴┤┬┤┴┤┬┤┴┤┬┤┴┤┬┤┤┴┬┬┤┴┤┬┤┴┤┬┤┴┤┬┤┴┤┬|┬┤┴┤┬┤┴┤┬|┤┴┤┬┤┴┤┬┤┴┤┬┤┴┤┬┤┴┤┬┤┴├|┤┴┤┬┤┴┤┬┤┴┤┬┤┴┤┬┤┴┤┬┤┴┤┬┤┴┤┬|
|┬┤┤┤┬┬┤┴┤┬┤┴┤┬┤┴┤┤┤┴┤┤┤┴┤┬|┴├┤┬|┴├┤┤┴┤┬┤┴┤┬┤┴┤┬┤┴┤┬┤┴┤┬├┤┴┤┬┤┴┤┬┤┴┤┬┤┴┤┬┤┴┤┬|┬┤┴┤┬┤┴┤┬|┤┴┤┬┤┴┤┬┤┴┤┬┤┴┤┬┤┴┤┬┤┴┤┤┤┴┤┬┤┴┤┬┤┴┤┬┤┴┤┬┤┴┤┬┤┴┤┬┤┴┤┬|
|======┤┴┤┬┤┴┤┬┤┴┤┬┤┴┤┬┤┴┤┬├├├┤┬├├├┬┤┴┤┬┤┴┤┬┤┴┤┬┤┴┤┬┤┤┴┬┬┤┴┤┬┤┴┤┬┤┴┤┬┤┴┤┬┤┴┤┬|┬┤┴┤┬┤┴┤┬|┤┴┤┬┤┴┤┬┤┴┤┬┤┴┤┬┤┴┤┬┤┴┤┬┤┴┤┬┤┴┤┬┤┴┤┬┤┴┤┬┤┴┤┬┤┴┤┬┤┴┤┬|
|     |┤┴┤┬┤┴┤┬┤┴┤┬┤┴┤┬┤┤┴┬┬┬┤┴┬┬┬┤┬┤┴┤┬┤┴┤┬┤┴┤┬┤┴┤┬├┤┴┤┬┤┴┤┬┤┴┤┬┤┴┤┬┤┴┤┬┤┴┤┬|┬┤┴┤*┤┴┤┬|┤┴┤┬┤┴┤┬┤┴┤┬┤┴┤┬┤┴┤┬┤┴┤┬┤┴┤┬┤┴┤┬┤┴┤┬┤┴┤┬┤┴┤┬┤┴┤┬*┴┤┬|
|  *  |┤┤┤┬┤┤┤┬┤┤┤┬┤┤┤┬├┤┤┤┤┤┤┤┤┤┤┤┬┤┤┤┬┤┤┤┬┤┤┤┬┤┤┤┬┬┤┤┤┬┤┤┤┬┤┤┤┬┤┤┤┬┤┤┤┬┤┤┤┬|┬┤┤┤┬┤┤┤┬|┤┤┤┬┤┤┤┬┤┤┤┬┤┤┤┬┤┤┤┬┤┤┤┬┤┤┤┬┤┤┤┬┤┤┤┬┤┤┤┬┤┤┤┬┤┤┤┬┤┤┤┬|
=============================================================================================================================================
