==========================================================================
|┴┤s├├├├├├├├├├├├├├├├├├├├├├├├├├├├├├|┴├├├├├├├├├├├├├├├├├├├├├├├├├├├├├├├├├├├├├|
|┤┤┬┬┬┬┬┬┬┬┬┬┬┬┬┬┬┬┬┬┬┬┬┬┬┬┬┬┬┬┬┬┬|┴├┬┬┬┬┬┬┬┬┬┬┬┬┬┬┬┬┬┬┬┬┬┬┬┬┬┬┬┬┬┬┬┬┬┬┬┬|
|====================┴├├├├├├├├├├┤┬|┴├┤┴├├├├├├├├├├├├├├├├├├├├├├├├┤┤┤┴┤┤┤┴┤┬|
|┴┤┤┤┴┤┤┤┴┤┤┤┴┤┤┤┴├├├├├┬┬┬┬┬┬┬┬┬┤┬├├├┤┴├┬┬┬┬┬┬┬┬┬┬┬┬┬┬┬┬┬┬┬┬┬┬┬┤┬┤┴┤┬┤┴┤┬|
|┴┤┬┤┴┤┬┤┴┤┬┤┴┤┬┤┴├┬┬┬┤┤┤┤┤┤┤┤┤┬├┬┬┬┤┤┴├┴┤┤┤┴┤┤┤┴┤┤┤┴┤┤┤┴┤┤┤┴┤*┤┬┤┴┤┬┤┴┤┬|
|┴┤┬┤┴┤┬┤┴┤┬┤┴┤┬┤┴├===================┴├┴┤┬┤┴┤┬┤┴┤┬┤┴┤┬┤┴┤┬┤┴┤┬┤┬┤┴┤┬┤┴┤┬|
|┴┤┬┤┴┤┬┤┴┤┬┤┴┤┬┤┴┤┤┤┴┤┤┤┴┤┤┤┴┤┤┤┴┤┤┤┴├├┴┤┬┤┴┤┬┤┴┤┬┤┴┤┬┤┴┤┬┤┴┤┬┤┬┤┴┤┬┤┴┤┬|
|┴┤┬┤┴┤┬┤┴┤┬┤┴┤┬┤┴┤┬┤┴┤┬┤┴┤┬┤┴┤┬┤┴┤┬┤┴├┤┴┤┬┤┴┤┬┤┴┤┬┤┴┤┬┤┴┤┬┤┴┤┬┤┬┤┴┤┬┤┴┤┬|
|┴┤┬┤┴┤┬┤┴┤┬┤┴┤┬┤┴┤┬┤┴┤┬┤┴┤┬┤┴┤┬┤┴┤┬┤┴├┤┤┤┬┤┤┤┬┤┤┤┬┤┤┤┬┤┤┤┬┤┤┤┬┤┬┤┴┤┬┤┴┤┬|
|┴┤┬┤┴┤┬┤┴┤┬┤┴┤┬┤*┤┬┤┴┤┬┤┴┤┬┤┴┤┬┤┴┤┬┤┴==========================┬┤┴┤┬┤┴┤┬|
|┴┤┬┤┴┤┬┤┴┤┬┤┴┤┬┤┴┤┬┤┴┤┬┤┴┤┬┤┴┤┬┤┴┤┬┤┴┤┤┤┴┤┤┤┴├┤┤┤┴┤┤┤┴┤┤┤┴┤┤┤┴┤┬┤┴┤┬┤┴┤┬|
|┴┤┬┤┴┤┬┤┴┤┬┤┴┤┬┤┴┤┬┤┴┤┬┤┴┤┬┤┴┤┬┤┴┤┬┤┴┤┬┤┴┤┬┤┴┤┤┬┤┴┤┬┤┴┤┬┤┴┤┬┤┴┤┬┤┴┤┬┤┴┤┬|
|┤┤┬┤┤┤┬┤┤┤┬┤┤┤┬┤┤┤┬┤┤┤┬┤┤┤┬┤┤┤┬┤┴┤┬┤┴┤┬┤┴┤┬┤┴┤┬|┤┴┤┬┤┴┤┬┤┴┤┬┤┴┤┬┤┴┤┬┤┴┤┬|
|================================┴┤┬┤┴┤┬┤┴┤┬┤┴┤┬|┤┴┤┬┤┴┤┬┤┴┤┬┤┴┤┬┤┴┤┬┤┴┤┬|
|┴┤┤┤┴┤┤┤┴┤┤┤┴┤┤┤┴┤┤┤┴┤┤┤┴┤┤┤┴┤┤┤┴┤┬┤┴┤┬┤┴┤┬┤┴┤┬|┤┴┤┬┤┴┤┬┤┴┤┬┤┴┤┬┤┴┤┬┤┴┤┬|
|┴┤┬┤┴┤┬┤┴┤┬┤┴┤┬┤┴┤┬┤┴*┬┤┴┤┬┤┴┤┬┤┴┤┬┤┴┤┬┤┴┤┬┤┴┤┬|┤┴┤┬┤┴┤┬┤┴┤┬┤┴┤┬┤┴┤┬┤┴┤┬|
|┴┤┬┤┴┤┬┤┴┤┬┤┴┤┬┤┴┤┬┤┴┤┬┤┴┤┬┤┴┤┬┤┴┤┬┤┴┤┬┤┴┤┬┤┴┤┬|┤┴┤┬┤┴┤┬┤┴┤┬┤┴┤┬┤┴┤┬┤┴┤┬|
|┴┤┬┤┴┤┬┤┴┤┬┤┴┤┬┤┴┤┬┤┴┤┬┤┴┤┬┤┴┤┬┤┴┤┬┤┴┤┬┤┴┤┬┤┴┤┬|┤┴┤┬┤┴┤┬┤┴┤┬┤┴┤┬┤┴┤┬┤┴┤┬|
|┤┤┬┤┤┤┬┤┤┤┬┤┤┤┬┤┤┤┬┤┤┤┬┤┤┤┬┤┤┤┬┤┤┤┬┤┤┤┬┤┤┤┬┤┤┤┬|┤┤┤┬┤┤┤┬┤┤┤┬┤┤┤┬┤┤┤┬┤┤┤*|
=========================================================================
