=============================================================================================================================================
|┴┤┴┤┤┴┤┴┤┤┤┤┤┤┤┤┤┤┤┤┤┤┴┴┤┴┤┤┴┤┴|┴┴┤┤┤┤┤┤┤┤┤┴┴┤┤┤┤┤┤┴┤┤┴┤┤┴┤┴┴┤┴┤┤┤┴┴├┴┴├├┴├├├┴┴┴┴┴┴├├┴┴┴┴┴┴├├┴┴┴┴├├├├├├├┴┴┴┴├┴┴┴┴┴┴├├┴┴┴┴┴┴├├┴┴┴┴┴┴├├┴┴┴*├├|
|┤┴┤*┤┤┴┤┴┤┤┤┤┤┤┤┤┤┤┤┤┴┤┤┴┤┴┤┤┴┴|┴┴┴┤┤┤┤┤┤┤┴┴┤┤┤┤┤┤┴┤┤┴┤┤┤┤┴┤┴┴┤┴┤┤┴┴├┴┴┴├├┴┴┴┴┴┴┴┴├├┴┴┴┴┴┴├├┴┴┴┴┴┴├├├├├├├┴┴┴├┴┴┴┴┴├├┴┴┴┴┴┴├├┴┴┴┴┴┴├├┴┴┴┴┴├├|
|┤┤┴┤┴┤┤┴┤┴┤┤┤┤┤┤┤┤┤┤┴┤┤┤┤┴┤┴┤┴┴|┴┴┴┴┤┤┴┤┤┴┴┤┤┤┤┤┤┴┤*┴┤┤┴┤┤┤┴┤┴┴┤┴┤┴┴├┴┴┴┴├├┴┴├┴├┴├├┴┴┴┴┴┴├├┴┴┴┴┴┴┴┴├├├├├├├┴┴├┴┴┴┴├├┴┴┴┴┴┴├├┴┴┴┴┴┴├├┴┴┴┴┴┴├┴|
|┤┤┤┴┤┴┤┤┴┤┴┤┤┤┤┤┤┤┤┴┤┤┤┤┤┤┴┴┴┤┤┤┤┴┴┴┴┴┤┴┴┴┤┤┤┤┤┤┴┤┤┴┤┤┤┤┴┤┤┤┴┤┴┴┤┴┴┴├┴┴┴┴┴├├├├├├├├├├├├├├├├├├├├├┴┴┴┴┴├├├├├├├├├├├├├├├├├├├├├├├├├├├├├├├├├├├├├├┴|
|┤┤┤┤┴┤┴┤┤┴┤┴┤┤┤┤┤┤┴┤┤┤┤┤┤┤┤┴┤┤┤┤┤┤┴┴┤┴┴┴┴┤┤┤┤┤┤┴┤┤┴┤┤┤┤┴┴┤┤┤┤┴┤┴┴┤┴┴├┴┴┴┴┴┴├=================┬├├┴┴┴┴┴├├├==================================┴|
|┤┤┤┤┤┴┤┴┤┤┴┤┴┤┤┤┤┴┤┤┤┤┤┴┤┬|┤┴┤┬|┤┤┤┤┴┤┴┴┤┤┤┤┤┤┴┤┤┴┤┤┤┤┤┴┴┤┤┤┤┤┴┤┴┴┴┴├├┴┴┴┴┴┴|┤┤┴┤┤┤┴├┤┤┤┴├├├├┬┬├├┴┴┴┴┴├├├├├├├├|┴├├├┴├├├├┴┴┴┴├├┴┴┴┴├├├├├├├├├|
|┤┤┤┤┤┤┴┤┴┤┤┴┤┴┤┤┴┤┤┤┤┤┤┴┤┬|┤*┤┬|┤┤┤┤┤┴┴┤┤┤┤┤┤┴┤┤┴┤┤┤┤┤┤┴┴┤┤┤┤┤┤┴┤┴┴┴├┴┴┴┴┴┴┴|┬┤┴┤┬┤┴├┤┬┤┴├┬┬┬├┬┬├├├┴┴┴┴├├├├├├├|┴├*├├├├├┴┴┴┴├├┴┴┴┴┴┴├├├├├├├├|
|┤┤┤┤┤┤┤┴┤┴┤┴┴┴┴┤┤┤┤┤┤┤┤┤┤┬|┤┤┤┬|┤┤┤┤┤┤┤┤┴┴┴┴┴┴┤┴┤┤┤┤┤┤┤┴┴┴┴┴┴┴┤┴┴┤┴├├├┴┴┴┴┴┴|┬┤┴┤┬┤┴┤┤┬┤┴├┴├┬┬├┬┬├├┴┴┴┴┴┴┴┴┴┴┴|┴├┬┬├├┴┴┴┴┴├├┴┴┴┴┴┴┴┴┴┴┴┴┴┴┴|
|┤┤┤┤┤┤┤┤┴┤┴┤┴┴┤┴┤┬======================┴┴┴┴┴┤┴┤┤┤┤┤┤┤┤┴┴┴┴┴┴┴┴┤┤┴┴┴├├┴┴┴┴┴┴|┬┤┴┤┬┤┴┤┬|┤┴├┴├├┬┬├┬┬├├┴┴┴┴┴┴┴┴┴┴|┴├┴┬┬├├┴┴┴├├┴┴┴┴┴┴┴┴┴┴┴┴┴┴┴┴|
|┤┤┤┤┤┤┤┤┤┤┤┤┤┤┤┤┤┬├├├├├├├├|    |┤┤┤┤┤┤┤┤┤┤┤┤┤┤┤┤┤┤┤┤┤┤┤┤┤┤┤┤┤┤┤┤┤┤s├├├├├├├├├|┬┤┴┤┬┤┴┤┬|┤┴├┴├┬├┬┬├┬┬├├├├├├├├├├├|┴├┴├┬┬├├├├├├├├├├├├├├├├├├├├├├|
|┬┬┬┬┬┬┬┬┤┬┤┬┤┤┬┤┤┬┬┬*┬┬┬┬┬|  * |┬┤┤*┬┤┤┤┤┤┤┤┤┬┤┬┬┬┬┬┬┬┬┤┤┤┤┤┤┤┤┤┤┬┬├├├├├├├├├|┬┤┴┤┬┤┴┤┬|┤┴├┴├┬┤┤┬┤┤┬┬├├├├├├├├├├|┴├┴┤┤┬┬├├├├├├├├├├├├├├├├├├├├├|
|┬┬┬┬┬┬┬┬┬┤┬┤┬┤┤┬┤┤┤┤┤┤┤┤┤┬|    |┤┬┬┤┬┬┤┤┤┤┤┤┬┤┬┬┬┬┬┬┬┬┬┬┤┤┤┤┤┤┤┤┤┬┬┬┬┬┬┬┬┬┬┬|┬┤┴┤┬┤┴┤┬|┤┴├┴├┤┤┬┤┤┬┬├*┬├├├├├├├├|┴├┤┤┬┬├├├┬┬┬┬┬┬┬┬┬┬├├├├├├├├├|
|┤┬┬┬┬┬┬┬┬┬┤┬┤┬┤┤┬┬======================┤┤┤┬┤┬┬┬┬┬┬┬┬┬┬*┬┤┤┤┤┤┤┤┤┬┬┬├├├├├├├├|┬┤┴┤┬┤┴┤┬|┤┴├┴┤┤┬┤┤┬┬├├├┬┬├├├├├├├|┴├┤┬┬├├├┬┬├├├├├├├├┬┬├├├├├├├├|
|┤┤┬┬┬┬┬┬┬┬┬┤┬┤┬┤┤┤┤┤┤┤┤┤┤┴|┤┤┤┴|┤┤┤┤┤┤┤┤┤┤┬┤┬┬┬┬┬┬┬┬┬┬┬┬┬┬┤┤┤┤┤┤┤┬┬├├├├├├├├├|┬┤┴┤┬┤┴┤┬|┤┴├┤┤┬┤┤┬┬├├├├├┬┬├├├├├├|┴├┬┬├├├┬┬├├├├├├├├├├┬┬├├├├├├├|
|┬┤┤┬┬┬┬┬┬┬┬┬┤┬┤┬┤┤┤┤┤┤┤┬┤┴|┤┬*┴|┤┤┤┤┤┤┤┤┤┬┤┬┬┬┬┬┬┬┬┬┬┬┬┬┬┬┬┤┤┤┤┤┤┬┬├├├├├├├├├|┬┤┴┤┬┤┴┤┬|┤┴├┤┬┤┤┬┬├├├├├├├┬┬├├├├├|┴├┬├├├┬┬├├├├├├├├├├├├┬┬├├├├├├|
|┬┬┤┤┬┬┬┬┬┬┬┬┬┤┬┤┬┤┤┤┤┤┤┬┤┴|┤┬┤┴|┤┤┤┤┤┤┤┤┬┤┬┬┬┬┬┬┬┬┬┬┬┬┬┬┬┬┬┬┤┤┤┤┤┬┬├├├├├├├├├|┬┤┴┤┬┤┴┤┬|┤┴├┬┤┤┬┬├├├├├├├├├┬┬├├├├├├├├├├┬┬├├├├├├├├├├├├├├┬┬├├├├├|
|======┬┬┬┬┬┬┬┬┤┬┤┬┤┤┤┤┬┤┤┤┤┬┤┤┤┤┬┤┤┤┤┤┤┬┤┬┬┬┬┬┬┬┬┬┬┬┬┬┬┬┬┬┬┬┬┤┤┤┤┬┬├├├├├├├├├|┬┤┴┤┬┤┴┤┬|┤┴├┤┤┬┬├├├├├├├├├├├┬┬├├├├├├├├┬┬├├├├├├├├├├├├├├├├┬┬├├├├|
|     |┬┬┬┬┬┬┬┬┬┤┬┤┬┤┤┬┤┬┤┤┬┤┬┤┬┬┤┬┤┤┤┤┬┤┬┬┬┬┬┬┬┬┬┬┬┬┬┬┬┬┬┬┬┬┬┬┤┤┤┬┬├├├├├├├├├|┬┤┴┤*┤┴┤┬|┤┴┤┤┬┬├├├├├├├├├├├├├┬┬├├├├├├┬┬├├├├├├├├├├├├├├├├├├┬*├├├|
|  *  |┤┬┬┬┬┬┬┬┬┬┤┬┤┬┬┤┬┤┬┬┤┬┤┬┬┬┬┤┬┤┤┬┤┬┬┬┬┬┬┬┬┬┬┬┬┬┬┬┬┬┬┬┬┬┬┬┬┤┤┬┬├├├├├├├├├|┬┤┤┤┬┤┤┤┬|┤┤┤┬┬├├├├├├├├├├├├├├├┬┬├├├├┬┬├├├├├├├├├├├├├├├├├├├├┬┬├├|
=============================================================================================================================================
