==========================================================================
|┤┤┤s├├├├├├├├├├├├├├├├├├├├├├├├├├├├├├├├├├├├├├├├├├├├├├├├├├├├├├├├├├├├├├├├├├├├|
|┤┤┬┬├┬├├├├├├├├├├├├├├├├├├├├├├├├├├├├├├├├├├*├├├├├├├├├├├├├├├├├├├├├├├├├├├├├├├|
|=======================================================┬├├├├├├├├├├├├┬┬├├|
|┤┤┴┤┤┤┴┤┤┤┴┤┤┤┴┤┤┤┴┤┤┤┴┤┤┤┴┤┤┤┴┤┤┤┴┤┤┤┴┤┤┤┴┤┤┤┴┤┤┤┴├├┤┤┬┬├├├├├├├├├├┬┬┬┬├|
|┬┤┴*┬┤┴┤┬┤┴┤┬┤┴┤┬┤┴┤┬┤┴┤┬┤┴┤┬┤┴┤┬┤┴┤┬┤┴┤┬┤┴*┬┤┴┤┬┤┴├┤┤┬┬┬┬├├├├├├├├┬┬├├┬┬|
|┬┤┴┤┬┤┴┤┬┤┴┤┬┤┴┤┬┤┴┤┬┤┴┤┬┤┴┤┬┤┴┤┬┤┴┤┬┤┴┤┬┤┴┤┬┤┴┤┬┤┴┤┤┬┬├├┬┬├├├├├├┬┬├├├├┬|
|┬┤┴┤┬┤┴┤┬┤┤┤┬┤┤┤┬┤┤┤┬┤┤┤┬*┤┤┬┤┤┤┬┤┤┤┬┤┤┤┬┤┤┤┬┤┤┤┬┤┤┤┬┬├├├├┬┬├├├├┬┬├├├├├├|
|┬┤┴┤┬┤┴┤┬├┬=======================================================┬├├├├├|
|┬┤┴┤┬┤┤┴┬┬├├├├├├├├├├├├├├├├├├├├├├├├├├├├├├├├├├├├├├├├├├├├├├├├├├├├├├├├┬├├├├├|
|┬┤┴┤┬├┤┤*┬┬┬┬┬┬┬┬┬┬┬┬┬┬┬┬┬┬┬┬┬┬┬┬┬┬┬┬┬┬┬┬┬┬┬┬┬┬┬┬┬┬├├├├├├├├├├├├├├├┬├├├├├|
|┬┤┤┤┬┬├┤┤┤┤┤┤┤┤┤┤┤┤┤┤┤┤┤┤┤┤┤┤┤┤┤┤┤┤┤┤┤┤┤┤┤┤┤┤┤┤┤┬┬├┬┬├├├├┬┬├├├├├├├├├├├├├|
|==========================================================┬┬├├├├├├├├├├├├|
|┤┴┤┤┤┴├┤┤┤┴┤┤┤┴┤┤┤┴┤┤┤┴┤┤┤┴┤┤┤┴┤┤┤┴┤┤┤┴┤┤┤┴┤┤┤┴┤┤┤┴┤┤┤┴├┤┤┬┬┬├├├├├├├├├├├|
|┤┴┤┬┤┴├┤┬┤┴┤┬┤┴┤┬┤┴┤┬*┴┤┬┤┴┤┬┤┴┤┬┤┴┤┬┤┴┤┬┤┴┤*┤┴┤┬┤┴┤┬┤┴┤┤┬┬├┬┬├├├├├├├├├├|
|┤┴┤┬┤┴┤┤┬┤┤┤┬┤┤┤┬┤┤┤┬┤┤┤┬┤┤┤┬┤┤┤┬┤┤┤┬┤┤┤┬┤┤┤┬┤┤┤┬┤┤┤┬┤┤┤┬┬├├├├├├├├├├├├├┬|
|┤┴┤┬┤┴┤┬=======================================================┬├├├├├├┬┬|
|┤┴┤┬┤┴┤┬├├├├├├├├├├├├├├├├├├├├├├├├├├├├├├├├├├├├├├├├├├├├├├├├├├├├├├├├├├├├├┬┬├|
|┤┴┤┬┤┤┴┬┬┬┬┬*┬┬┬┬┬┬┬┬┬┬┬┬┬┬┬┬┬*┬┬┬┬┬┬┬┬┬┬┬┬┬┬┬┬┬┬┬┬┬*┬┬├├├├├├├├├├├├├┬┬├├|
|┤┤┤┬├┤┤┤┤┤┤┤┤┤┤┤┤┤┤┤┤┤┤┤┤┤┤┤┤┤┤┤┤┤┤┤┤┤┤┤┤┤┤┤┤┤┤┤┤┤┤┤┬┬├┬┬├├├├┬┬├├├├┬┬├├├|
==========================================================================
