==========================================================================
|┤┤s├├├├├├├├├├├├├├├├├├├├├├├├├├├├├├|┴├├├├├├├├├├├├├├├├├├├├├├├├├├├├├├├├├├├├├|
|┤┬┬├┬├├├├├├├├├├├├├├├├├├├├├├├├├├├├|┴├┬┬├├├├├├├├├├├├├├├├├├├├├├├├├├├├├├├├├├|
|====================┬┬┬├├├├├├├├┬┬|┴├┬├┬┬├├├├├├├├├├├├├├├├┬┬├├├├├├├├├├├├├├|
|┤┴┤┤┤┴┤┤┤┴├├├├┤┤┤┴┤┤┬┬┬┬├├├├├├┬┬┬├├├├┬┬┬┬├├├├├├├├├├├├├├┬┬┬┬├├├├├├├├├├├├├|
|┤┴┤┬┤┴┤┬┤┴├┬┬┬┤┬┤┤┤┬┬├├┬┬├├├├┬┬├├├├├┬┬├├┬┬├├├├├├├├├├├├┬┬├├┬┬├*├├├├├├├├├├|
|┤┴┤┬┤┴┤┬┤┴├┴┤┬┤┬├┬===================┬├├├┬┬├├├├├├├├├├┬┬├├├├┬┬├├├├├├├├├├├|
|┤┴┤┬┤┴┤┬┤┴├┴┤┬├┬┬├├├├├├├├├├├├├├├├├├├├┬├├├├┬┬├├├├├├├├┬┬├├├├├├┬┬├├├├├├├├├├|
|┤┴┤┬┤┴┤┬┤┴├┤┤┬┤┤┬┬├├├├├├├├├├├├├├├├├├├┬├├├├├┬┬├├├├├├┬┬├├├├├├├├┬┬├├├├├├├├├|
|┤┴┤┬┤┴┤┬┤┴├┤┬┤┤┬┬├┬┬├├├├├├├├├├├├┬┬├├├├├├├├├├┬┬├├├├┬┬├├├├├├├├├├┬┬├├├├├├├├|
|┤┴┤┬┤┴┤┬┤┴├┬┤┤┬┬*├┬┬┬├├├├├├├├├├┬┬┬┬├├==========================┬┬├├├├├├├|
|┤┴┤┬┤┴┤┬┤┴├┤┤┬┬├├┬├├┬┬├├├├├├├├┬┬├├├├├├├├├├├├├├├├├├├├├├├├├├├├├├├┬┬┬├├├├├├|
|┤┴┤┬┤┴┤┬┤┴┤┤┬┬├├┬├├├├┬┬├├├├├├┬┬├├├├├├├├├├├├├├├├├├├├├├├├├├├├├├├├┬├┬┬├├├├├|
|┤┤┤┬┤┤┤┬┤┤┤┬┬├├┬├├├├├├┬┬├├├├┬┬├├├├├├├├├├├├├├├├├|┬┬├├├├├├├├├├├├├├├├┬┬├├├├|
|================================┬├├┬┬┬┬├├├├├├├├|┬┬┬├├├├├├├├├├├├├├├├┬┬├├├|
|┤┤┴┤┤┤┴┤┤┤┴┤┤┤┴┤┤┤┴┤┤┤┴┤┤┤┴├├├┤┤┬├├├├├├├├├├├├├┬|┬├┬┬├├├├├├├├├├├├├├├├┬┬├├|
|┬┤┴┤┬┤┴┤┬┤┴┤┬┤┴┤┬┤┴┤┬*┴┤┬┤┴├┬┤┤┬┬├├├├├├├├├├├├┬┬|┬├├┬┬├├├├├├├├├├├├├├├├┬┬├|
|┬┤┴┤┬┤┴┤┬┤┴┤┬┤┴┤┬┤┴┤┬┤┴┤┬┤┴├┤┤┬┬├├├├├├├├├├├├┬┬├|┬├├├┬┬├├├├├├├├├├├├├├├├┬┬|
|┬┤┴┤┬┤┴┤┬┤┴┤┬┤┴┤┬┤┴┤┬┤┴┤┬┤┴┤┤┬┬├├├├┬┬├├├├├├┬┬├├|┬├├├├┬┬├├├├├├├├├├├├├├├├┬|
|┬┤┤┤┬┤┤┤┬┤┤┤┬┤┤┤┬┤┤┤┬┤┤┤┬┤┤┤┬┬├├├├├├┬┬├├├├┬┬├├├|┬├├├├├┬┬├├├├├├├├├├├├├├├*|
=========================================================================
